あせ	(;˘ᴗ˘)	名詞
あばば	( ꒪q꒪)	名詞
おう	 L( ◠‿◠ )ォゥ	名詞
おっ	（＾ω＾）	名詞
がしゃーん	( ﾞ'ωﾞ` )	名詞
ぐっ	( ・ᴗ・)b	名詞
けいれい	(｀･ω･´)ゞ	名詞
ころしあえー	(^o^) ﾉ＜ころしあえー	名詞
ころせ	=͟͟͞͞=͟͟͞͞ ☞ ´◔‿ゝ◔`)=͟͟͞͞=͟͟͞͞ ☞	名詞
しょぼ	（´◔ω◔`）	名詞
ずこー	ヽ(･ω･)/ ｽﾞｺｰ	名詞
にっこり	（◜◡◝）	名詞
のし	( ・ᴗ・)ﾉｼ	名詞
はぁ	ʅ(´◔౪◔)ʃ	名詞
ふぁっきゅー	( ・ᴗ・)d	名詞
ぶぉん	('ω'ω'ω'=三='='ω'=三=三=三=三='ω'=三='ω'ω'ω'ω'ω')ﾌﾞｫﾝﾌﾞｫﾝ	名詞
ふてね	_(:3｣∠)_	名詞
ふとん	(:3っ)っ -=三[_____]	名詞
へー	( ´・◡・｀)	名詞
まじきち	( ◠‿◠ )	名詞
みくおじ	｡оО(｡´•ㅅ•｡)Оо。	名詞
みなぎってきた	ʅ(◔౪◔ʅ)三(ʃ◔౪◔)ʃ	名詞
ゆのっち	✘╹◡╹✘	名詞
んひぃ	∩(´；ヮ；｀)∩ンヒィ～ｗｗｗｗｗｗｗｗｗｗｗｗｗｗ	名詞
